╔══════════════════════════════════════════════════════════════════════════════╗
║          │                                                        │          ║
║          │                                                        │          ║
║          │                                                        │          ║
║          │                                                        │          ║
║          │                                                        │          ║
║          │                                                        │          ║
║          │                                                        │          ║
║          │                                                @@      │          ║
║          │                                               @@@      │          ║
║          │    {─}          ▒▒                            {─}      │          ║
║          │     ║         ▒▓▓█▒                            ║       │          ║
║          │     ║        ▒█████▒                           ║       │          ║
║          │     ^       ▒▓██████▓▒                         ^       │          ║
║          │             ▒████████▓▒                                │          ║
║          │              ▓███████▒                                 │          ║
║          │               ▒▒▓▓▒▒▒                                  │          ║
║          │                 ▒▒                                     │          ║
║          ──────────────────────────────────────────────────────────          ║
║         /               ▀ ■   ▌ ■             ────\██─────         \         ║
║        /               ▐    ▀  ·                █████     │  ___    \        ║
║       /                                       ────/██─────  (xΩx)    \       ║
║      /                                                                \      ║
║     /                                                                  \     ║
╚══════════════════════════════════════════════════════════════════════════════╝