╔══════════════════════════════════════════════════════════════════════════════╗
║          │                                                        │          ║
║          │                                                        │          ║
║          │                                                        │          ║
║          │                                                        │          ║
║          │                                                        │          ║
║          │                                                        │          ║
║          │                                                        │          ║
║          │                                                @@      │          ║
║          │                                               @@@      │          ║
║          │    {─}          ▒▒                            {─}      │          ║
║          │     ║         ▒▓▓█▒                            ║       │          ║
║          │     ║        ▒█████▒                           ║       │          ║
║          │     ^       ▒▓██████▓▒              _--_       ^       │          ║
║          │             ▒████████▓▒            (■ ▄ )>             │          ║
║          │              ▓███████▒              \──│   \           │          ║
║          │               ▒▒▓▓▒▒▒                 /│ / │           │          ║
║          │                 ▒▒                   | │|  │           │          ║
║          ─────────────────────────────────────────█████────────────          ║
║         /               ▀ ■   ▌ ■                 /███\            \         ║
║        /               ▐    ▀  ·                 / ███ \            \        ║
║       /                                          │     │             \       ║
║      /                                                                \      ║
║     /                                                                  \     ║
╚══════════════════════════════════════════════════════════════════════════════╝