╔══════════════════════════════════════════════════════════════════════════════╗
║      │                                                               │       ║
║      │                                                               │       ║
║      │                                                               │       ║
║      │                                                               │       ║
║      │                                                               │       ║
║      │                                                               │       ║
║      │                             ────────────                      │       ║
║      │             @              /            \                     │       ║
║      │            @@@            /  ┌┬┬┬┬┬┬┬┬┬┐ \                    │       ║
║      │            @@@           │   ├┼┼┼┼┼┼┼┼┼┤  │                   │       ║
║      │            {─}           │   └┴┴┴┴┴┴┴┴┴┘  │                   │       ║
║      │             ║            │                │                   │       ║
║      │             ║            │                │                   │       ║
║      │             ^            │                │                   │       ║
║      │                          │ Θ              │                   │       ║
║      │            ___           │                │                   │       ║
║      │           (   )          │                │                   │       ║
║      │             |            │                │                   │       ║
║      │          ⌐--|--¬         │                │                   │       ║
║      ──────────/──-|-─⌡────────────────────────────────────────────────      ║
║     /             -|-                                                  \     ║
║    /             /   \                                                  \    ║
║   /             /     \                                                  \   ║
╚══════════════════════════════════════════════════════════════════════════════╝